0000000000000000000000000
0555555555555555555555550
0511155555555555555511150
0511155555555555555511150
0511155555555555555511150
0555555555555555555555550
0555555555555555555555550
0555555555555555555555550
0555555555555555555555550
0555555555555555555555550
0555555555555555555555550
0555555555511155555555550
0555555555511155555555550
0555555555511155555555550
0555555555555555555555550
0555555555555555555555550
0555555555555555555555550
0555555555555555555555550
0555555555555555555555550
0555555555555555555555550
0511155555555555555511150
0511155555555555555511150
0511155555555555555511150
0555555555555555555555550
0000000000000000000000000