0000000000000000000000000
0555555555555555555555550
0566666565656565656666650
0565555555555555555555650
0565111565656565651115650
0565111555555555551115650
0565111565656565651115650
0555555555555555555555550
0555555555555555555555550
0555565555555555555655550
0555575555555555555755550
0555585555511155555855550
0567898765511155678987650
0555585555511155555855550
0555575555555555555755550
0555565555555555555655550
0555555555555555555555550
0555555555555555555555550
0565111565656565651115650
0565111555555555551115650
0565111565656565651115650
0565555555555555555555650
0566666565656565656666650
0555555555555555555555550
0000000000000000000000000